Character Builder Lite	Ron's Character Planner	DDO Builder
Acrobatic	Acrobatic	Acrobatic
Adamantine Body	Adamantine Body	Adamantine Body
Adept of Forms	Monk Feats: Adept of Forms	
Alertness	Alertness	Alertness
Arcane Insight	Epic: Arcane Insight	Arcane Insight
Arcane Pulse	Arcane Sphere: Arcane Pulse	Arcane Pulse
Arcane Warrior	Multiple Spheres: Arcane Warrior	Arcane Warrior
Armor Proficiency: Heavy	Heavy Armor Proficiency	Heavy Armor Proficiency
Armor Proficiency: Light	Light Armor Proficiency	Light Armor Proficiency
Armor Proficiency: Medium	Medium Armor Proficiency	Medium Armor Proficiency
Athletic	Athletic	Athletic
Augment Summoning	Augment Summoning	Augment Summoning
Beloved of: Amaunator	Beloved of Amaunator	Beloved of Amaunator
Beloved of: Aureon	Beloved of Aureon	
Beloved of: Helm	Beloved of Helm	
Beloved of: Lord of Blades	Beloved of the Lord of Blades	Beloved of the Lord of Blades
Beloved of: Olladra	Beloved of Olladra	
Beloved of: Onatar	Beloved of Onatar	
Beloved of: Silvanus	Beloved of Silvanus	
Beloved of: Silver Flame	Beloved of the Silver Flame	Beloved of the Silver Flame
Beloved of: Sovereign Host	Beloved of the Sovereign Host	Beloved of the Sovereign Host
Beloved of: The Blood of Vol	Beloved of the Blood of Vol	
Beloved of: Undying Court	Beloved of the Undying Court	Beloved of the Undying Court
Beloved of: Vulkoor	Beloved of Vulkoor	Beloved of Vulkoor
Blinding Speed	Epic: Blinding Speed	Blinding Speed
Bond of the Fallen	Aasimar: Bond: Protector	Bond of the Fallen
Bond of the Protector	Aasimar: Bond: Fallen	Bond of the Protector
Bow Strength	Bow Strength	Bow Strength
Brutal Throw	Brutal Throw	Brutal Throw
Bullheaded	Bullheaded	Bullheaded
Bulwark of Defense	Epic: Bulwark of Defense	Bulwark of Defense
Burst of Glacial Wrath	Epic: Burst of Glacial Wrath	Burst of Glacial Wrath
Child of: Amaunator	Child of Amaunator	Child of Amaunator
Child of: Aureon	Child of Aureon	Child of Aureon
Child of: Helm	Child of Helm	Child of Helm
Child of: Lord of Blades	Child of the Lord of Blades	Child of the Lord of Blades
Child of: Olladra	Child of Olladra	Child of Olladra
Child of: Onatar	Child of Onatar	Child of Onatar
Child of: Silvanus	Child of Silvanus	Child of Silvanus
Child of: Silver Flame	Child of the Silver Flame	Child of the Silver Flame
Child of: Sovereign Host	Child of the Sovereign Host	Child of the Sovereign Host
Child of: The Blood of Vol	Child of the Blood of Vol	Child of the Blood of Vol
Child of: Undying Court	Child of the Undying Court	Child of the Undying Court
Child of: Vulkoor	Child of Vulkoor	Child of Vulkoor
Cleave	Cleave	Cleave
Combat Archery	Epic: Combat Archery	Combat Archery
Combat Casting	Combat Casting	Combat Casting
Combat Expertise	Combat Expertise	Combat Expertise
Completionist	Completionist	Completionist
Construct Essence	Construct Essence	Construct Essence
Construct Exemplar	Epic: Construct Exemplar	Construct Exemplar
Crippling Strike	Crippling Strike	Crippling Strike
Damage Reduction: Adamantine	Favored Soul Damage Reduction: Adamantine	Favored Soul Damage Reduction: Adamantine
Damage Reduction: Cold Iron	Favored Soul Damage Reduction: Cold Iron	Favored Soul Damage Reduction: Cold Iron
Damage Reduction: Good	Favored Soul Damage Reduction: Good	Favored Soul Damage Reduction: Good
Damage Reduction: Silver	Favored Soul Damage Reduction: Silver	Favored Soul Damage Reduction: Silver
Defensive Roll	Defensive Roll	Defensive Roll
Deflect Arrows	Deflect Arrows	Deflect Arrows
Deific Warding	Divine Sphere: Deific Warding	Deific Warding
Deity Ability: Amaunator's Flames	Amaunator's Brilliance	Amaunator's Brilliance
Deity Ability: Aureon's Instruction	Aureon's Instruction	Aureon's Instruction
Deity Ability: Bladesworn Transformation	Bladesworn Transformation	Bladesworn Transformation
Deity Ability: Blessing of Silvanus	Blessing of Silvanus	Blessing of Silvanus
Deity Ability: Ever Watchful	Ever Watchful	Ever Watchful
Deity Ability: Luck of Olladra	Luck of Olladra	Luck of Olladra
Deity Ability: Onatar's Forge	Ontar's Forge	Onatar's Forge
Deity Ability: Silver Flame Exorcism	Silver Flame Exorcism	Silver Flame Exorcism
Deity Ability: The Blood is The Life	The Blood is The Life	The Blood is The Life
Deity Ability: Undying Call	Undying Call	Undying Call
Deity Ability: Unyielding Sovereignty	Unyielding Sovereignty	Unyielding Sovereignty
Deity Ability: Vulkoor's Avatar	Vulkoor's Avatar	Vulkoor's Avatar
Diehard	Diehard	Diehard
Dire Charge	Martial Sphere: Dire Charge	Dire Charge
Discipline	Discipline	Discipline
Dodge	Dodge	Dodge
Domain: Air Domain	Domain: Air Domain	Air Domain Tier I
Domain: Animal Domain	Domain: Animal Domain	Animal Domain Tier I
Domain: Chaos Domain	Domain: Chaos Domain	Chaos Domain Tier I
Domain: Death Domain	Domain: Death Domain	Death Domain Tier I
Domain: Destruction Domain	Domain: Destruction Domain	Desctruction Domain Tier I
Domain: Earth Domain	Domain: Earth Domain	Earth Domain Tier I
Domain: Fire Domain	Domain: Fire Domain	Fire Domain Tier I
Domain: Good Domain	Domain: Good Domain	Good Domain Tier I
Domain: Healing Domain	Domain: Healing Domain	Healing Domain Tier I
Domain: Knowledge Domain	Domain: Knowledge Domain	Knowledge Domain Tier I
Domain: Law Domain	Domain: Law Domain	Law Domain Tier I
Domain: Luck Domain	Domain: Luck Domain	Luck Domain Tier I
Domain: Magic Domain	Domain: Magic Domain	Magic Domain Tier I
Domain: Protection Domain	Domain: Protection Domain	Protection Domain Tier I
Domain: Strength Domain	Domain: Strength Domain	Strength Domain Tier I
Domain: Sun Domain	Domain: Sun Domain	Sun Domain Tier I
Domain: Trickery Domain	Domain: Trickery Domain	Trickery Domain Tier I
Domain: War Domain	Domain: War Domain	War Domain Tier I
Domain: Water Domain	Domain: Water Domain	Water Domain Tier I
Doubleshot	Primal Sphere: Doubleshot	Doubleshot
Draconic Ancestry: Black	Draconic Ancestry: Black	Draconic Ancestry: Black
Draconic Ancestry: Blue	Draconic Ancestry: Blue	Draconic Ancestry: Blue
Draconic Ancestry: Red	Draconic Ancestry: Red	Draconic Ancestry: Red
Draconic Ancestry: White	Draconic Ancestry: White	Draconic Ancestry: White
Dreamscape	Multiple Spheres: Dreamscape	Dreamscape
Elusive Target	Martial Sphere: Elusive Target	Elusive Target
Embodiment of Law	Multiple Spheres: Embodiment of Order	Embodiment of Law
Embolden Spell	Epic: Embolden Spell	Embolden Spell
Empower Healing Spell	Empower Healing Spell	Empower Healing Spell
Empower Spell	Empower Spell	Empower Spell
Energy Absorption: Acid	Energy Resistance: Acid	Energy Absorption: Acid
Energy Absorption: Cold	Energy Resistance: Cold	Energy Absorption: Cold
Energy Absorption: Electricity	Energy Resistance: Electricity	Energy Absorption: Electricity
Energy Absorption: Fire	Energy Resistance: Fire	Energy Absorption: Fire
Energy Absorption: Sonic	Energy Resistance: Sonic	Energy Absorption: Sonic
Enlarge Spell	Enlarge Spell	Enlarge Spell
Epic Arcane Eldritch Blast	Arcane Sphere: Epic Arcane Eldritch Blast	Epic Arcane Eldritch Blast
Epic Damage Reduction	Epic: Epic Damage Reduction	Epic Damage Reduction
Epic Eldritch Blast	Epic: Epic Eldritch Blast	Epic Eldritch Blast
Epic Fortitude	Epic: Epic Fortitude	Epic Fortitude
Epic Mage Armor	Arcane Sphere: Epic Mage Armor	Epic Mage Armor
Epic Mental Toughness	Epic: Epic Mental Toughness	Epic Mental Toughness
Epic Reflexes	Epic: Epic Reflexes	Epic Reflexes
Epic Reputation	Epic: Epic Reputation	Epic Reputation
Epic Skill Focus: Balance	Martial Sphere: Epic Skill Focus: Balance	Epic Skill Focus: Balance
Epic Skill Focus: Bluff	Divine Sphere: Epic Skill Focus: Bluff	Epic Skill Focus: Bluff
Epic Skill Focus: Concentration	Arcane Sphere: Epic Skill Focus: Concentration	Epic Skill Focus: Concentration
Epic Skill Focus: Diplomacy	Divine Sphere: Epic Skill Focus: Diplomacy	Epic Skill Focus: Diplomacy
Epic Skill Focus: Disable Device	Arcane Sphere: Epic Skill Focus: Disable Device	Epic Skill Focus: Disable Device
Epic Skill Focus: Haggle	Divine Sphere: Epic Skill Focus: Haggle	Epic Skill Focus: Haggle
Epic Skill Focus: Heal	Divine Sphere: Epic Skill Focus: Heal	Epic Skill Focus: Heal
Epic Skill Focus: Hide	Martial Sphere: Epic Skill Focus: Hide	Epic Skill Focus: Hide
Epic Skill Focus: Intimidate	Primal Sphere: Epic Skill Focus: Intimidate	Epic Skill Focus: Intimidate
Epic Skill Focus: Jump	Primal Sphere: Epic Skill Focus: Jump	Epic Skill Focus: Jump
Epic Skill Focus: Listen	Divine Sphere: Epic Skill Focus: Listen	Epic Skill Focus: Listen
Epic Skill Focus: Move Silently	Primal Sphere: Epic Skill Focus: Move Silently	Epic Skill Focus: Move Silently
Epic Skill Focus: Open Lock	Martial Sphere: Epic Skill Focus: Open Lock	Epic Skill Focus: Open Lock
Epic Skill Focus: Perform	Arcane Sphere: Epic Skill Focus: Perform	Epic Skill Focus: Perform
Epic Skill Focus: Repair	Arcane Sphere: Epic Skill Focus: Repair	Epic Skill Focus: Repair
Epic Skill Focus: Search	Martial Sphere: Epic Skill Focus: Search	Epic Skill Focus: Search
Epic Skill Focus: Spellcraft	Arcane Sphere: Epic Skill Focus: Spellcraft	Epic Skill Focus: Spell Craft
Epic Skill Focus: Spot	Primal Sphere: Epic Skill Focus: Spot	Epic Skill Focus: Spot
Epic Skill Focus: Swim	Martial Sphere: Epic Skill Focus: Swim	Epic Skill Focus: Swim
Epic Skill Focus: Tumble	Primal Sphere: Epic Skill Focus: Tumble	Epic Skill Focus: Tumble
Epic Spell Focus: Abjuration	Epic: Epic Spell Focus: Abjuration	Epic Spell Focus: Abjuration
Epic Spell Focus: Conjuration	Epic: Epic Spell Focus: Conjuration	Epic Spell Focus: Conjuration
Epic Spell Focus: Enchantment	Epic: Epic Spell Focus: Enchantment	Epic Spell Focus: Enchantment
Epic Spell Focus: Evocation	Epic: Epic Spell Focus: Evocation	Epic Spell Focus: Evocation
Epic Spell Focus: Illusion	Epic: Epic Spell Focus: Illusion	Epic Spell Focus: Illusion
Epic Spell Focus: Necromancy	Epic: Epic Spell Focus: Necromancy	Epic Spell Focus: Necromancy
Epic Spell Focus: Transmutation	Epic: Epic Spell Focus: Transmutation	Epic Spell Focus: Transmutation
Epic Spell Penetration	Epic: Epic Spell Penetration	Epic Spell Penetration
Epic Spell Power: Acid	Arcane Sphere: Epic Spell Power: Acid	Epic Spell Power: Acid
Epic Spell Power: Acid	Primal Sphere: Epic Spell Power: Acid	Epic Spell Power: Acid
Epic Spell Power: Cold	Arcane Sphere: Epic Spell Power: Cold	Epic Spell Power: Cold
Epic Spell Power: Cold	Primal Sphere: Epic Spell Power: Cold	Epic Spell Power: Cold
Epic Spell Power: Electricity	Arcane Sphere: Epic Spell Power: Electricity	Epic Spell Power: Electricity
Epic Spell Power: Electricity	Primal Sphere: Epic Spell Power: Electricity	Epic Spell Power: Electricity
Epic Spell Power: Fire	Arcane Sphere: Epic Spell Power: Fire	Epic Spell Power: Fire
Epic Spell Power: Fire	Divine Sphere: Epic Spell Power: Fire	Epic Spell Power: Fire
Epic Spell Power: Fire	Primal Sphere: Epic Spell Power: Fire	Epic Spell Power: Fire
Epic Spell Power: Force	Arcane Sphere: Epic Spell Power: Force	Epic Spell Power: Force
Epic Spell Power: Light	Divine Sphere: Epic Spell Power: Light	Epic Spell Power: Light
Epic Spell Power: Negative	Divine Sphere: Epic Spell Power: Negative	Epic Spell Power: Negative
Epic Spell Power: Positive	Primal Sphere: Epic Spell Power: Positive	Epic Spell Power: Positive
Epic Spell Power: Repair	Arcane Sphere: Epic Spell Power: Repair	Epic Spell Power: Repair
Epic Spell Power: Sonic	Arcane Sphere: Epic Spell Power: Sonic	Epic Spell Power: Sonic
Epic Spell Power: Sonic	Primal Sphere: Epic Spell Power: Sonic	Epic Spell Power: Sonic
Epic Toughness	Epic: Epic Toughness	Epic Toughness
Epic Will	Epic: Epic Will	Epic Will
Eschew Materials	Eschew Materials	Eschew Materials
Exotic Weapon: Bastard Sword	Exotic Weapon Proficiency: Bastard Sword	Exotic Weapon Proficiency: Bastard Sword
Exotic Weapon: Dwarven Axe	Exotic Weapon Proficiency: Dwarven Waraxe	Exotic Weapon Proficiency: Dwarven Axe
Exotic Weapon: Great Crossbow	Exotic Weapon Proficiency: Great Crossbow	Exotic Weapon Proficiency: Great Crossbow
Exotic Weapon: Handwraps	Exotic Weapon Proficiency: Handwrap	
Exotic Weapon: Kama	Exotic Weapon Proficiency: Kama	Exotic Weapon Proficiency: Kama
Exotic Weapon: Khopesh	Exotic Weapon Proficiency: Khopesh	Exotic Weapon Proficiency: Khopesh
Exotic Weapon: Rpt Hvy Crossbow	Exotic Weapon Proficiency: Repeating Heavy Crossbow	Exotic Weapon Proficiency: Repeating Heavy Crossbow
Exotic Weapon: Rpt Lt Crossbow	Exotic Weapon Proficiency: Repeating Light Crossbow	Exotic Weapon Proficiency: Repeating Light Crossbow
Exotic Weapon: Shuriken	Exotic Weapon Proficiency: Shuriken	Exotic Weapon Proficiency: Shuriken
Extend Spell	Extend Spell	Extend Spell
Extra Turning	Extra Turning	Extra Turning
Favored Enemy: Aberration	Favored Enemy: Aberration	Favored enemy: Aberration
Favored Enemy: Animal	Favored Enemy: Animal	Favored enemy: Animal
Favored Enemy: Chaotic Outsider	Favored Enemy: Chaotic Outsider	Favored enemy: Chaotic Outsider
Favored Enemy: Construct	Favored Enemy: Construct	Favored enemy: Construct
Favored Enemy: Dragon	Favored Enemy: Dragon	Favored enemy: Dragon
Favored Enemy: Dwarf	Favored Enemy: Dwarf	Favored enemy: Dwarf
Favored Enemy: Elemental	Favored Enemy: Elemental	Favored enemy: Elemental
Favored Enemy: Elf	Favored Enemy: Elf	Favored enemy: Elf
Favored Enemy: Evil Outsider	Favored Enemy: Evil Outsider	Favored enemy: Evil Outsider
Favored Enemy: Giant	Favored Enemy: Giant	Favored enemy: Giant
Favored Enemy: Gnoll	Favored Enemy: Gnoll	Favored enemy: Gnoll
Favored Enemy: Goblinoid	Favored Enemy: Goblinoid	Favored enemy: Goblinoid
Favored Enemy: Halfling	Favored Enemy: Halfling	Favored enemy: Halfling
Favored Enemy: Human	Favored Enemy: Human	Favored enemy: Human
Favored Enemy: Lawful Outsider	Favored Enemy: Lawful Outsider	Favored enemy: Lawful Outsider
Favored Enemy: Magical Beast	Favored Enemy: Magical Beast	Favored enemy: Magical Beast
Favored Enemy: Monstrous Humanoid	Favored Enemy: Monstrous Humanoid	Favored enemy: Monstrous Humanoid
Favored Enemy: Ooze	Favored Enemy: Ooze	Favored enemy: Ooze
Favored Enemy: Orc	Favored Enemy: Orc	Favored enemy: Orc
Favored Enemy: Plant	Favored Enemy: Plant	Favored enemy: Plant
Favored Enemy: Reptilian	Favored Enemy: Reptillian	Favored enemy: Reptilian
Favored Enemy: Undead	Favored Enemy: Undead	Favored enemy: Undead
Favored Enemy: Vermin	Favored Enemy: Vermin	Favored enemy: Vermin
First Blood	Martial Sphere: First Blood	First Blood
Follower of: Amaunator	Favored by Amaunator	Favored by Amaunator
Follower of: Aureon	Follower of Aureon	Follower of Aureon
Follower of: Helm	Favored by Helm	Favored by Helm
Follower of: Lord of Blades	Follower of the Lord of Blades	Follower of the Lord of Blades
Follower of: Olladra	Follower of Olladra	Follower of Olladra
Follower of: Onatar	Follower of Onatar	Follower of Onatar
Follower of: Silvanus	Favored by Silvanus	Favored by Silvanus
Follower of: Silver Flame	Follower of the Silver Flame	Follower of the Silver Flame
Follower of: Sovereign Host	Follower of the Sovereign Host	Follower of the Sovereign Host
Follower of: The Blood of Vol	Follower the Blood of Vol	Follower of the Blood of Vol
Follower of: Undying Court	Follower of the Undying Court	Follower of the Undying Court
Follower of: Vulkoor	Follower of Vulkoor	Follower of Vulkoor
Force of Personality	Force of Personality	Force of Personality
Forced Escape	Divine Sphere: Forced Escape	Forced Escape
Fount of Life	Multiple Spheres: Fount of Life	Fount of Life
Grace of Battle	Grace of Battle	Grace of Battle
Grandmaster of Forms	Monk Feats: Grandmaster of Forms	Grandmaster of Forms
Great Ability: Charisma	Epic: Great Charisma	Great Charisma
Great Ability: Constitution	Epic: Great Constitution	Great Constitution
Great Ability: Dexterity	Epic: Great Dexterity	Great Dexterity
Great Ability: Intelligence	Epic: Great Intelligence	Great Intelligence
Great Ability: Strength	Epic: Great Strength	Great Strength
Great Ability: Wisdom	Epic: Great Wisdom	Great Wisdom
Great Cleave	Great Cleave	Great Cleave
Great Fortitude	Great Fortitude	Great Fortitude
Greater Ruin	Epic: Greater Ruin	Greater Ruin
Greater Single Weapon Fighting	Greater Single Weapon Fighting	Greater Single Weapon Fighting
Greater Spell Focus: Abjuration	Greater Spell Focus: Abjuration	Greater Spell Focus: Abjuration
Greater Spell Focus: Conjuration	Greater Spell Focus: Conjuration	Greater Spell Focus: Conjuration
Greater Spell Focus: Enchantment	Greater Spell Focus: Enchantment	Greater Spell Focus: Enchantment
Greater Spell Focus: Evocation	Greater Spell Focus: Evocation	Greater Spell Focus: Evocation
Greater Spell Focus: Illusion	Greater Spell Focus: Illusion	Greater Spell Focus: Illusion
Greater Spell Focus: Necromancy	Greater Spell Focus: Necromancy	Greater Spell Focus: Necromancy
Greater Spell Focus: Transmutation	Greater Spell Focus: Transmutation	Greater Spell Focus: Transmutation
Greater Spell Penetration	Greater Spell Penetration	Greater Spell Penetration
Greater Two Handed Fighting	Greater Two Handed Fighting	Greater Two Handed Fighting
Greater Two Weapon Fighting	Greater Two Weapon Fighting	Greater Two Weapon Fighting
Greater Weapon Focus: Bludgeoning	Greater Weapon Focus: Bludgeoning Weapons	Greater Weapon Focus: Bludgeoning Weapons
Greater Weapon Focus: Piercing	Greater Weapon Focus: Piercing Weapons	Greater Weapon Focus: Piercing Weapons
Greater Weapon Focus: Ranged	Greater Weapon Focus: Ranged Weapons	Greater Weapon Focus: Ranged Weapons
Greater Weapon Focus: Slashing	Greater Weapon Focus: Slashing Weapons	Greater Weapon Focus: Slashing Weapons
Greater Weapon Focus: Thrown	Greater Weapon Focus: Thrown Weapons	Greater Weapon Focus: Thrown Weapons
Greater Weapon Specialization: Bludgeoning	Greater Weapon Specialization: Bludgeoning Weapons	Greater Weapon Specialization: Bludgeoning Weapons
Greater Weapon Specialization: Piercing	Greater Weapon Specialization: Piercing Weapons	Greater Weapon Specialization: Piercing Weapons
Greater Weapon Specialization: Ranged	Greater Weapon Specialization: Ranged Weapons	Greater Weapon Specialization: Ranged Weapons
Greater Weapon Specialization: Slashing	Greater Weapon Specialization: Slashing Weapons	Greater Weapon Specialization: Slashing Weapons
Greater Weapon Specialization: Thrown	Greater Weapon Specialization: Thrown Weapons	Greater Weapon Specialization: Thrown Weapons
Guardian Angel	Divine Sphere: Guardian Angel	Guardian Angel
Half-Elf Dilettante: Artificer	Half-Elf Dilettante: Artificer	Half-Elf Dilettante: Artificer
Half-Elf Dilettante: Barbarian	Half-Elf Dilettante: Barbarian	Half-Elf Dilettante: Barbarian
Half-Elf Dilettante: Bard	Half-Elf Dilettante: Bard	Half-Elf Dilettante: Bard
Half-Elf Dilettante: Cleric	Half-Elf Dilettante: Cleric	Half-Elf Dilettante: Cleric
Half-Elf Dilettante: Druid	Half-Elf Dilettante: Druid	Half-Elf Dilettante: Druid
Half-Elf Dilettante: Favored Soul	Half-Elf Dilettante: Favored Soul	Half-Elf Dilettante: Favored Soul
Half-Elf Dilettante: Fighter	Half-Elf Dilettante: Fighter	Half-Elf Dilettante: Fighter
Half-Elf Dilettante: Monk	Half-Elf Dilettante: Monk	Half-Elf Dilettante: Monk
Half-Elf Dilettante: Paladin	Half-Elf Dilettante: Paladin	Half-Elf Dilettante: Paladin
Half-Elf Dilettante: Ranger	Half-Elf Dilettante: Ranger	Half-Elf Dilettante: Ranger
Half-Elf Dilettante: Rogue	Half-Elf Dilettante: Rogue	Half-Elf Dilettante: Rogue
Half-Elf Dilettante: Sorcerer	Half-Elf Dilettante: Sorcerer	Half-Elf Dilettante: Sorcerer
Half-Elf Dilettante: Warlock	Half-Elf Dilettante: Warlock	Half-Elf Dilettante: Wizard
Half-Elf Dilettante: Wizard	Half-Elf Dilettante: Wizard	Half-Elf Dilettante: Wizard
Hamstring	Hamstring	Hamstring
Harbinger of Chaos	Multiple Spheres: Harbinger of Chaos	Harbinger of Chaos
Heavy Armor Champion	Heavy Armor Champion	Heavy Armor Champion
Heavy Armor Combatant	Heavy Armor Combatant	Heavy Armor Combatant
Heavy Armor Master	Heavy Armor Master	Heavy Armor Master
Heavy Armor Training	Heavy Armor Training	Heavy Armor Training
Heighten Spell	Heighten Spell	Heighten
Hellball	Arcane Sphere: Hellball	Hellball
Holy Strike	Divine Sphere: Holy Strike	Holy Strike
Improved Augment Summoning	Epic: Improved Augment Summoning	Improved Augment Summoning
Improved Bardic Music	Improved Bardic Music	Improved Bardic Music
Improved Construct Essence	Improved Construct Essence	Improved Construct Essence
Improved Critical: Bludgeoning	Improved Critical: Bludgeoning Weapons	Improved Critical: Bludgeoning Weapons
Improved Critical: Piercing	Improved Critical: Piercing Weapons	Improved Critical: Piercing Weapons
Improved Critical: Ranged	Improved Critical: Ranged Weapons	Improved Critical: Ranged Weapons
Improved Critical: Slashing	Improved Critical: Slashing Weapons	Improved Critical: Slashing Weapons
Improved Critical: Thrown	Improved Critical: Thrown Weapons	Improved Critical: Thrown Weapons
Improved Damage Reduction	Improved Damage Reduction	Improved Damage Reduction
Improved Evasion	Improved Evasion	Improved Evasion
Improved Feint	Improved Feint	Improved Feint
Improved Fortification	Improved Fortification	Improved Fortification
Improved Martial Arts	Epic: Improved Martial Arts	Improved Martial Arts
Improved Mental Toughness	Improved Mental Toughness	Improved Mental Toughness
Improved Precise Shot	Improved Precise Shot	Improved Precise Shot
Improved Shield Bash	Improved Shield Bash	Improved Shield Bash
Improved Shield Mastery	Improved Shield Mastery	Improved Shield Mastery
Improved Single Weapon Fighting	Improved Single Weapon Fighting	Improved Single Weapon Fighting
Improved Sneak Attack	Epic: Improved Sneak Attack	Improved Sneak Attack
Improved Sunder	Improved Sunder	Improved Sunder
Improved Trip	Improved Trip	Improved Trip
Improved Turning	Improved Turning	Improved Turning
Improved Two Handed Fighting	Improved Two Handed Fighting	Improved Two Handed Fighting
Improved Two Weapon Fighting	Improved Two Weapon Fighting	Improved Two Weapon Fighting
Insightful Reflexes	Insightful Reflexes	Insightful Reflexes
Inspire Excellence	Epic: Inspire Excellence	Inspire Excellence
Intensify Spell	Epic: Intensify Spell	Intensify Spell
Iron Will	Iron Will	Iron Will
Knowledge of Battle	Knowledge of Battle	Knowledge of Battle
Lasting Inspiration	Arcane Sphere: Lasting Inspiration	Lasting Inspiration
Least Dragonmark: Finding	Least Dragonmark of Finding	Least Dragonmark of Finding
Least Dragonmark: Healing	Least Dragonmark of Healing	Least Dragonmark of Healing
Least Dragonmark: Making	Least Dragonmark of Making	Least Dragonmark of Making
Least Dragonmark: Passage	Least Dragonmark of Passage	Least Dragonmark of Passage
Least Dragonmark: Scribing	Least Dragonmark of Scribing	Least Dragonmark of Scribing
Least Dragonmark: Sentinel	Least Dragonmark of Sentinel	Least Dragonmark of Sentinel
Least Dragonmark: Shadow	Least Dragonmark of Shadow	Least Dragonmark of Shadow
Least Dragonmark: Storm	Least Dragonmark of Storm	Least Dragonmark of Storm
Least Dragonmark: Warding	Least Dragonmark of Warding	Least Dragonmark of Warding
Lightning Reflexes	Lightning Reflexes	Lightning Reflexes
Luck of Heroes	Luck of Heroes	Luck Of Heroes
Magical Training	Magical Training	Magical Training
Manyshot	Manyshot	Manyshot
Martial Weapon: Battleaxe	Martial Weapon Proficiency: Battleaxe	Martial Weapon Proficiency: Battle Axe
Martial Weapon: Falchion	Martial Weapon Proficiency: Falchion	Martial Weapon Proficiency: Falchion
Martial Weapon: Greataxe	Martial Weapon Proficiency: Greataxe	Martial Weapon Proficiency: Great Axe
Martial Weapon: Greatclub	Martial Weapon Proficiency: Greatclub	Martial Weapon Proficiency: Great Club
Martial Weapon: Greatsword	Martial Weapon Proficiency: Greatsword	Martial Weapon Proficiency: Greatsword
Martial Weapon: Handaxe	Martial Weapon Proficiency: Handaxe	Martial Weapon Proficiency: Hand Axe
Martial Weapon: Heavy Pick	Martial Weapon Proficiency: Heavy Pick	Martial Weapon Proficiency: Heavy Pick
Martial Weapon: Kukri	Martial Weapon Proficiency: Kukri	Martial Weapon Proficiency: Kukri
Martial Weapon: Light Hammer	Martial Weapon Proficiency: Light Hammer	Martial Weapon Proficiency: Light Hammer
Martial Weapon: Light Pick	Martial Weapon Proficiency: Light Pick	Martial Weapon Proficiency: Light Pick
Martial Weapon: Longbow	Martial Weapon Proficiency: Longbow	Martial Weapon Proficiency: Longbow
Martial Weapon: Longsword	Martial Weapon Proficiency: Longsword	Martial Weapon Proficiency: Longsword
Martial Weapon: Maul	Martial Weapon Proficiency: Maul	Martial Weapon Proficiency: Maul
Martial Weapon: Rapier	Martial Weapon Proficiency: Rapier	Martial Weapon Proficiency: Rapier
Martial Weapon: Scimitar	Martial Weapon Proficiency: Scimitar	Martial Weapon Proficiency: Scimitar
Martial Weapon: Shortbow	Martial Weapon Proficiency: Shortbow	Martial Weapon Proficiency: Shortbow
Martial Weapon: Shortsword	Martial Weapon Proficiency: Shortsword	Martial Weapon Proficiency: Shortsword
Martial Weapon: Throwing Axe	Martial Weapon Proficiency: Throwing Axe	Martial Weapon Proficiency: Throwing Axe
Martial Weapon: Throwing Hammer	Martial Weapon Proficiency: Throwing Hammer	Martial Weapon Proficiency: Throwing Hammer
Martial Weapon: Warhammer	Martial Weapon Proficiency: Warhammer	Martial Weapon Proficiency: Warhammer
Mass Frog	Primal Sphere: Mass Frog	Mass Frog
Master of Forms	Monk Feats: Master of Forms	Master of Forms
Master of: Air	Epic: Master of Air	Master of Air
Master of: Alignment	Epic: Master of Alignment	Master of Alignment
Master of: Artifice	Epic: Master of Artifice	Master of Artifice
Master of: Earth	Epic: Master of Earth	Master of Earth
Master of: Fire	Epic: Master of Fire	Master of Fire
Master of: Knowledge	Epic: Master of Knowledge	Master of Knowledge
Master of: Light	Epic: Master of Light	Master of Light
Master of: Music	Epic: Master of Music	Master of Music
Master of: the Dead	Epic: Master of the Dead	Master of the Dead
Master of: the Wilds	Epic: Master of the Wilds	Master of the Wilds
Master of: Water	Epic: Master of Water	Master of Water
Maximize Spell	Maximize Spell	Maximize
Mental Toughness	Mental Toughness	Mental Toughness
Mithral Body	Mithral Body	Mithral Body
Mithral Fluidity	Mithral Fluidity	Mithral Fluidity
Mobile Spellcasting	Mobile Spellcasting	Mobile Spellcasting
Mobility	Mobility	Mobility
Natural Fighting	Natural Fighting	Natural Fighting
Negotiator	Negotiator	Negotiator
Nimble Fingers	Nimble Fingers	Nimble Fingers
Opportunist	Opportunist	Opportunist
Oversized Two Weapon Fighting	Oversized Two Weapon Fighting	Oversized Two Weapon Fighting
Overwhelming Critical	Epic: Overwhelming Critical	Overwhelming Critical
Pact: Fey	Warlock: Pact: Fey	Warlock: Pact Magic: Fey
Pact: Fiend	Warlock: Pact: Fiend	Warlock: Pact Magic: Fiend
Pact: Great Old One	Warlock: Pact: Great Old One	Warlock: Pact Magic: Great Old One
Past Life: Artificer	Past Life: Student of Artifice	Past Life: Student of Artifice
Past Life: Barbarian	Past Life: Berserker's Fury	Past Life: Berserker's Fury
Past Life: Bard	Past Life: Bardic Dilettante	Past Life: Bardic Dilettante
Past Life: Cleric	Past Life: Initiate of the Faith	Past Life: Initiate of the Faith
Past Life: Druid	Past Life: Harbinger of Nature's Wrath	Past Life: Harbinger of Nature's Wrath
Past Life: Favored Soul	Past Life: Acolyte of Divine Secrets	Past Life: Acolyte of Divine Secrets
Past Life: Fighter	Past Life: Student of the Sword	Past Life: Student of the Sword
Past Life: Monk	Past Life: Disciple of the Fist	Past Life: Disciple of the Fist
Past Life: Paladin	Past Life: Soldier of the Faith	Past Life: Soldier of the Faith
Past Life: Ranger	Past Life: Warrior of the Wild	Past Life: Warrior of the Wild
Past Life: Rogue	Past Life: Sneak of Shadows	Past Life: Sneak of Shadows
Past Life: Sorcerer	Past Life: Arcane Prodigy	Past Life: Arcane Prodigy
Past Life: Warlock	Past Life: Delver of the Forbidden	Past Life: Delver of the Forbidden
Past Life: Wizard	Past Life: Arcane Initiate	Past Life: Arcane Initiate
Path of Harmonious Balance	Path of Harmonious Balance: Fists of Light	Path of Harmonious Balance: Fists of Light
Path of Inevitable Dominion	Path of Inevitable Dominion: Fists of Darkness	Path of Inevitable Dominion: Fists of Darkness
Perfect Single Weapon Fighting	Martial Sphere: Perfect Single Weapon Fighting	Perfect Single Weapon Fighting
Perfect Two Handed Fighting	Primal Sphere: Perfect Two Handed Fighting	Perfect Two Handed Fighting
Perfect Two Weapon Fighting	Primal Sphere: Perfect Two Weapon Fighting	Perfect Two Weapon Fighting
Pierce Damage Reduction: Adamantine	Martial Sphere: Pierce Adamantine	Pierce Adamantine
Pierce Damage Reduction: Byeshk	Martial Sphere: Pierce Byeshk	Pierce Byeshk
Pierce Damage Reduction: Cold Iron	Martial Sphere: Pierce Cold Iron	Pierce Cold Iron
Pierce Damage Reduction: Silver	Martial Sphere: Pierce Silver	Pierce Silver
Point Blank Shot	Point Blank Shot	Point Blank Shot
Power Attack	Power Attack	Power Attack
Power Critical	Power Critical	Power Critical
Precise Shot	Precise Shot	Precise Shot
Precision	Precision	Precision
Purity of Heart	Purity of Heart	Purity of Heart
Quick Draw	Quick Draw	Quick Draw
Quicken Spell	Quicken Spell	Quicken
Rapid Reload	Rapid Reload	Rapid Reload
Rapid Shot	Rapid Shot	Rapid Shot
Resilience	Resilience	Resilience
Resist Poison	Resist Poison	Resist Poison
Ruin	Epic: Ruin	Ruin
Sap	Sap	Sap
Scion of: Arborea	Scion of Arborea	Scion of Arborea
Scion of: Astral Plane	Scion of the Astral Plane	Scion of the Astral Plane
Scion of: Celestia	Scion of Celestia	Scion of Celestia
Scion of: Elysium	Scion of Elysium	Scion of Elysium
Scion of: Ethereal Plane	Scion of the Ethereal Plane	Scion of the Ethereal Plane
Scion of: Feywild	Scion of the Feywild	Scion of the Feywild
Scion of: Limbo	Scion of Limbo	Scion of Limbo
Scion of: Mechanus	Scion of Mechanus	Scion of Mechanus
Scion of: Plane of Air	Scion of the Plane of Air	Scion of the Plane of Air
Scion of: Plane of Earth	Scion of the Plane of Earth	Scion of the Plane of Earth
Scion of: Plane of Fire	Scion of the Plane of Fire	Scion of the Plane of Fire
Scion of: Plane of Water	Scion of the Plane of Water	Scion of the Plane of Water
Scion of: Shadowfell	Scion of the Shadowfell	Scion of the Shadowfell
Self Sufficient	Self Sufficient	Self Sufficient
Shield Deflection	Shield Deflection	Shield Deflection
Shield Mastery	Shield Mastery	Shield Mastery
Shield Proficiency	Shield Proficiency (General)	Shield Proficiency (General)
Shot on the Run	Shot on the Run	Shot on the Run
Shuriken Expertise	Shuriken Expertise	Shuriken Expertise
Simple Weapons	Simple Weapon Proficiency	
Single Weapon Fighting	Single Weapon Fighting	Single Weapon Fighting
Skill Focus: Balance	Skill Focus: Balance	Skill Focus: Balance
Skill Focus: Bluff	Skill Focus: Bluff	Skill Focus: Bluff
Skill Focus: Concentration	Skill Focus: Concentration	Skill Focus: Concentration
Skill Focus: Diplomacy	Skill Focus: Diplomacy	Skill Focus: Diplomacy
Skill Focus: Disable Device	Skill Focus: Disable Device	Skill Focus: Disable Device
Skill Focus: Haggle	Skill Focus: Haggle	Skill Focus: Haggle
Skill Focus: Heal	Skill Focus: Heal	Skill Focus: Heal
Skill Focus: Hide	Skill Focus: Hide	Skill Focus: Hide
Skill Focus: Intimidate	Skill Focus: Intimidate	Skill Focus: Intimidate
Skill Focus: Jump	Skill Focus: Jump	Skill Focus: Jump
Skill Focus: Listen	Skill Focus: Listen	Skill Focus: Listen
Skill Focus: Move Silently	Skill Focus: Move Silently	Skill Focus: Move Silently
Skill Focus: Open Lock	Skill Focus: Open Lock	Skill Focus: Open Lock
Skill Focus: Perform	Skill Focus: Perform	Skill Focus: Perform
Skill Focus: Repair	Skill Focus: Repair	Skill Focus: Repair
Skill Focus: Search	Skill Focus: Search	Skill Focus: Search
Skill Focus: Spellcraft	Skill Focus: Spellcraft	Skill Focus: Spellcraft
Skill Focus: Spot	Skill Focus: Spot	Skill Focus: Spot
Skill Focus: Swim	Skill Focus: Swim	Skill Focus: Swim
Skill Focus: Tumble	Skill Focus: Tumble	Skill Focus: Tumble
Skill Focus: Use Magic Device	Skill Focus: Use Magic Device	Skill Focus: Use Magic Device
Skill Mastery	Skill Mastery	Skill Mastery
Slicing Blow	Slicing Blow	Slicing Blow
Slippery Mind	Slippery Mind	Slippery Mind
Snake Blood	Snake Blood	Snake Blood
Spell Focus: Abjuration	Spell Focus: Abjuration	Spell Focus: Abjuration
Spell Focus: Conjuration	Spell Focus: Conjuration	Spell Focus: Conjuration
Spell Focus: Enchantment	Spell Focus: Enchantment	Spell Focus: Enchantment
Spell Focus: Evocation	Spell Focus: Evocation	Spell Focus: Evocation
Spell Focus: Illusion	Spell Focus: Illusion	Spell Focus: Illusion
Spell Focus: Necromancy	Spell Focus: Necromancy	Spell Focus: Necromancy
Spell Focus: Transmutation	Spell Focus: Transmutation	Spell Focus: Transmutation
Spell Penetration	Spell Penetration	Spell Penetration
Spirit Blades	Multiple Spheres: Spirit Blades	Spirit Blades
Spring Attack	Spring Attack	Spring Attack
Stealthy	Stealthy	Stealthy
Stout of Heart	Stout of Heart	Stout of Heart
Stunning Blow	Stunning Blow	Stunning Blow
Stunning Fist	Stunning Fist	Stunning Fist
Superior Weapon Focus: Bludgeoning	Superior Weapon Focus: Bludgeoning Weapons	Superior Weapon Focus: Bludgeoning Weapons
Superior Weapon Focus: Piercing	Superior Weapon Focus: Piercing Weapons	Superior Weapon Focus: Piercing Weapons
Superior Weapon Focus: Ranged	Superior Weapon Focus: Ranged Weapons	Superior Weapon Focus: Ranged Weapons
Superior Weapon Focus: Slashing	Superior Weapon Focus: Slashing Weapons	Superior Weapon Focus: Slashing Weapons
Superior Weapon Focus: Thrown	Superior Weapon Focus: Thrown Weapons	Superior Weapon Focus: Thrown Weapons
Tactical Combatant	Tacticle Combatant	Tactical Combatant
Tactical Mastery	Tacticle Master	Tactical Mastery
Tactical Supremacy	Tacticle Supremacy	Tactical Supremacy
Tactical Training	Tacticle Training	Tactical Training
Tactician	Martial Sphere: Tactician	Tactician
Ten Thousand Stars	Ten Thousand Stars	Ten Thousand Stars
Toughness	Toughness	Toughness
Tower Shield Proficiency	Tower Shield Proficiency	Tower Shield Proficiency
Two Handed Fighting	Two Handed Fighting	Two Handed Fighting
Two Weapon Blocking	Two Weapon Blocking	Two Weapon Blocking
Two Weapon Defense	Two Weapon Defense	Two Weapon Defense
Two Weapon Fighting	Two Weapon Fighting	Two Weapon Fighting
Vorpal Strikes	Epic: Vorpal Strikes	Vorpal Strikes
Watchful Eye	Epic: Watchful Eye	Watchful Eye
Weapon Finesse	Weapon Finesse	Weapon Finesse
Weapon Focus: Bludgeoning	Weapon Focus: Bludgeoning Weapons	Weapon Focus: Bludgeoning Weapons
Weapon Focus: Piercing	Weapon Focus: Piercing Weapons	Weapon Focus: Piercing Weapons
Weapon Focus: Ranged	Weapon Focus: Ranged Weapons	Weapon Focus: Ranged Weapons
Weapon Focus: Slashing	Weapon Focus: Slashing Weapons	Weapon Focus: Slashing Weapons
Weapon Focus: Thrown	Weapon Focus: Thrown Weapons	Weapon Focus: Thrown Weapons
Weapon Specialization: Bludgeoning	Weapon Specialization: Bludgeoning Weapons	Weapon Specialization: Bludgeoning Weapons
Weapon Specialization: Piercing	Weapon Specialization: Piercing Weapons	Weapon Specialization: Piercing Weapons
Weapon Specialization: Ranged	Weapon Specialization: Ranged Weapons	Weapon Specialization: Ranged Weapons
Weapon Specialization: Slashing	Weapon Specialization: Slashing Weapons	Weapon Specialization: Slashing Weapons
Weapon Specialization: Thrown	Weapon Specialization: Thrown Weapons	Weapon Specialization: Thrown Weapons
Wellspring of Power	Epic: Wellspring of Power	Wellspring of Power
Whirling Steel Strike	Whirling Steel Strike	Whirling Steel Strike
Whirlwind Attack	Whirlwind Attack	Whirlwind Attack
Wild Shape 1: Bear	Wild Shape: Bear	Wild Shape: Bear
Wild Shape 1: Wolf	Wild Shape: Wolf	Wild Shape: Wolf
Wild Shape 2: Dire Bear	Wild Shape: Dire Bear	Wild Shape: Dire Bear
Wild Shape 2: Winter Wolf	Wild Shape: Winter Wolf	Wild Shape: Winter Wolf
Wild Shape 3: Fire Elemental	Wild Shape: Fire Elemental	Wild Shape: Fire Elemental
Wild Shape 3: Water Elemental	Wild Shape: Water Elemental	Wild Shape: Water Elemental
Wind through the Trees	Wind through the Trees	
Zen Archery	Zen Archery	Zen Archery
